 (UsagiSpoon)  

Yotsubato reading helper  

I put the words into their standard forms.  

すげぇ = 凄い

とーちゃん = お父さん

そーだろー = そうだろう

おねーちゃん = お姉ちゃん

手ぇふった = 手を振った

ほーら = ほら

持ってくんなよ = 持ってくるなよ

ひろっとく = 拾っておく

どっから = どこから

捨てんのかな = 捨てるのかな

しっかりしてんなぁーと思って = しっかりしてるな、と思って

あっしたから　なっつ　やっす　み　= 明日から夏休み

はなしちゃ = 離しては

こえー = 怖い 

知ってんだ = 知ってるんだ

まてー = 待って

いてぇ = 痛い

つえー = 強い

うめぇ = うまい

かみなげー = 髪長い

きれー = 綺麗

ごちそー = ごちそう

いらん = 要らない

あ　れぇ　= あれ

わかんねー = わからない

おまかいですが = お構いですが　(spoof of お構いなく)  

こんなんあった = こんなのあった

きてごらーん = 来て御覧

ゔ = screaming version of う　
　
なんてゆーか = なんというか

気にすんな = 気にするな

そーだよなー = そうだよなぁ

テキトーに = 適当に

おれいをゆう = お礼を言う

おれーいいにきた = お礼言いに来た

あつーくなって = 暑くなって

とっても = とても

ばーちゃん = おばあさん

じーちゃん = おじいさん

これもて = これ持って

でか = デカい

コイ = 来い

ビミョーニョ = misreading of 美少女(びしょうじょ)

おっきー = 大きい

おいてくぞ = 置いておくぞ

ならねー = ならない

泣かねー = 泣かない

でけーな = デカいな








